###########################################################
###########################################################
###########################################################
#####################                 #####################
####################  ###############  ####################
#################    #################   ##################
###############   ######################    ###############
############    ########################### ###############
###########  #############################  ###############
########### #############################  ################
####        ######################        #################
###  ############################  ########################
S   ############################  #########################
######################           ##########################
###################### ####################################
#####################  ####################################
###################  ######################################
##################  #######################################
#################  ##########       #######################
################  ##########  #####  ######################
################ ########    #######  #####################
################  ######   ##########  ####################
#################  ####  #############  ###################
##################  ##  ###############  ##################
###################    ##################  ################
##########################################  ###############
###########################################  ##############
############################################  #############
#############################################             E
###########################################################
###########################################################
###########################################################
###########################################################